&	dan
/	atau
@	di
+	tambah
=	sama dengan
7an	tujuan
aaamiiin	amin
aaamiin	amin
aamiiin	amin
aamiin	amin
aamin	amin
ababil	anak muda labil
abal	palsu
abal2	palsu
abis	habis
acc	disetujui
accord	sesuai
ad	ada
adlah	adalah
adlh	adalah
adoh	aduh
afaik	as far as i know
aha	tertawa
ahaha	haha
ahiok	ahok
ahokncc	ahok
aing	saya
aj	saja
aja	saja
ajepajep	dunia gemerlap
ajj	saja
ak	aku
ak	saya
aka	dikenal juga sebagai
akhirx	akhirnya
akika	aku
akko	aku
akkoh	aku
akku	aku
akooh	aku
akuwh	aku
akyu	aku
alay	norak
albm	album
aljasa	asal jadi saja
all	semua
almaidahyg	almaidah
alow	halo
ama	sama
ambilin	ambilkan
ambl	ambil
amerik	amarika
amiin	amin
ampe	sampai
analisise	analisis
ancur	hancur
angis	nangis
anjay	anjing
anjim	anjing
anjir	anjing
anjrit	anjing
ank	anak
anter	antar
any	setiap
anyway	ngomong ngomong
ap	apa
ap2	apa apa
apaan	apa
apasih	apa sih
apd	alat pelindung diri
ape	apa
apes	sial
aplot	unggah
aps	apa
apva	apa
aq	aku
aqu	aku
aquwh	aku
asap	secepatnya
asap	sesegera mungkin
asbun	asal bunyi
aseek	asyik
aseekk	asyik
asek	asyik
asekk	asyik
aseknya	asyiknya
asem	asam
asik	asyik
askum	assalamuallaikum
asn	aparatur sipil negara
asoy	asyik
aspal	asli tetapi palsu
astrojim	astagfirullahaladzim
astul	asal tulis
ath	kalau begitu
ato	atau
ato	atau
atuh	kalau begitu
atw	atau
au ah	tidak mau tahu
ava	foto profil
awak	saya
aws	awas
ay	sayang
ayang	sayang
ayank	sayang
ayok	ayo
ayoo	ayo
ayooo	ayo
ayyo	ayo
b4	sebelum
babe	bapak
bacot	banyak bicara
baget	keras kepala
bajir	banjir
bajir	banjir
bakalan	akan
bales	balas
bandes	bantuan desa
bangdes	pembangunan desa
bangedh	banget
bangkotan	tua
banpol	bantuan polisi
banpres	bantuan presiden
banpur	bantuan tempur
bansarkas	bantuan sarana Kesehatan
bansos	bantuan sosial
baper	bawa perasaan
bapuk	rusak
basbang	basi
bathin	batin
bawaslu	badan pengawas pemilihan umum
bazis	badan amal, zakat, infak, dan sedekah
bcanda	bercanda
bcoz	karena
bcr	bicara
bcs	karena
bcz	karena
bdg	bandung
beb	sayang
bebal	bodoh
bebeb	pacar
becus	mampu
bedakin	bedak
begajulan	nakal
begin	awal
bejibun	banyak
bejibun	bertumpuk banyak
beliin	belikan
belom	belum
benarjujur	benar
bences banci
bencong	banci
bener	benar
bentar	sebentar
benul	betul
ber2	berdua
ber3	bertiga
ber3	bertiga
berdikari	berdiri di atas kaki sendiri
beresin	membereskan
bet	banget
bete	bosan
beti	beda tipis
better	lebih baik
beud	banget
beut	banget
bf	pacar
bg	abang
bgd	banget
bgmn	bagaimana
bgs	bagus
bgt	banget
bgt	banget
bhas	bahas
bhay	sampai jumpa lagi
bhg	bahagia
bhubu	tidur
bijimane	bagaimana
bikin	buat
bimbuluh	bimbingan dan penyuluhan
bingit	banget
bingo	banget
bintal	bimbingan mental
bisi	kalau kalau
bkl	akan
bklan	bakalan
bkn	bukan
bknnya	bukannya
bl	beli
blegug	bodoh
blg	bilang
blh	boleh
blm	belum
bln	bulan
bls	balas
blum	belum
bnchi	benci
bnci	benci
bngung	bingung
bnr	benar
bnran	yang benar
bnyk	banyak
bodor	lucu
body	tubuh
bohay	badan aduhai
bokap	ayah
bokep	porno
boker	buang air besar
bokin	pacar
bokis	bohong
bole	boleh
boljug	boleh juga
bolot	bodoh
bonek	bocah nekat
bonyok	ayah ibu
boyeh	boleh
bpk	bapak
br	baru
bray	saudara laki-laki
brb	segera kembali
bre	saudara laki-laki
brg	bareng
brjaya	berjaya
brngkt	berangkat
bro	saudara laki
brp	berapa
bru	baru
bruh	saudara laki
brur	saudara laki
bs	bisa
bsa	bisa
bsen	bosan
bsk	besok
bt	bosan
btw	ngomong ngomong
bu_bu	tidur
buangbuang	buang
bubarin	bubarkan
bubbu	tidur
buber	buka bersama
bubu	tidur
bujubune	luar biasa
bumil	ibu hamil
buser	buru sergap
buzzerbuzzer	buzzer
bw	bawa
bwhn	bawahan
bwt	buat
bwt	buat
byar	bayar
bye	sampai jumpa lagi
byk	banyak
byr	bayar
byrin	bayarkan
c8	chat
cabal	sabar
cabut	pergi
cadas	keren
caem	cakep
cagub	calon gubernur
calo	makelar
cama cama	sama sama
can	belum
cangcut	celana dalam
capcus	pergi
cape	capek
capej	capek
capek	lelah
caper	cari perhatian
cashback	uang Kembali
caur	jelek
cawakot	calon wali kota
cawalkot	calon wali kota
cawalkot	calon wali kota
cayalah	percaya
cb	coba
ce cewek
ce	cewek
cekak	tidak ada uang
cekal	cegah tangkal
cekidot	coba lihat
cemen	penakut
cemplungin	cemplungkan
cengengesan	tertawa
ceper	pendek
cepet	cepat
ceu	kakak perempuan
cew	cewek
cew	cewek
cewe	cewek
chakep	cakep
chuyunk	sayang
cibuk	sibuk
cimeng	ganja
cin	cinta
cipika cipiki	cium pipi kanan cium pipi kiri
ciye	cie
ciyh	sih
ckck	ck
ckepp	cakep
ckp	cukup
clbk	cinta lama bersemi kembali
cluster	klaster
cm	cuma 
cmiiw	koreksi saya jika saya salah
cmpr	campur
cmpur	campur
cnenk	senang
cnt	cinta
co cowok
cong	banci
congor	mulut
congrats	selamat
conlok	cinta lokasi
connect		menghubung
contest	kontes
count	hitung
cow	cowok
cow	cowok
cowwyy	maaf
coz	karena
cp	siapa
cpa	siapa
cpe	capek
cppa	siapa
cppe	capek
cr	cara
crop	potong
cucok	cocok
cuek	tidak acuh
cuex	cuek
cuman	Cuma
cumi	Cuma miscall
cungkring	kurus tinggi
cups	culun
cupu	culun
curanmor	pencurian kendaraan bermotor
curas	pencurian dengan kekerasan
curcol	curahan hati colongan
curhat	curahan hati
cwe	cewek
cwek	cewek
cwo	cowok
cwok	cowok
cya	sampai jumpa lagi
cyin	cinta
cz	karena
d	di
da	ada
dafuk	kurang ajar
dagh	sudah
dah	deh
damang	sehat
damat	tidak peduli
dapet	dapat
dateng	datang
de	adik
dech	deh
dek	adik
deket	dekat
demen	suka
dempa	demi apa
dengerin	dengarkan
des	desember
detected	terdeteksi
detector	pendeteksi
deyh	deh
dg	dengan
dgn	dengan
dh	deh
diancurin	dihancurkan
digosipin	digosipkan
dimaafin	dimaafkan
dimana2	dimana mana
dimintak	diminta
dimna	dimana
disember	desember
disono	di sana
diuber	dikejar
dket	dekat
dkit	sedikit
dkk	dan kawan kawan
dkt	dekat
dl	dulu
dll	dan lain lain
dlm	dalam
dlu	dulu
dlu	dulu
dmn	dimana
dngn	dengan
doang	saja
dodol	bodoh
doi	dia
doku	uang
dom	domisili
done	selesai
dongs	dong
donlot	unduh
download	unduh
dpt	dapat
dr	dari
dri	dari
drmana	darimana
drmn	darimana
drpd	daripada
drtd	dari tadi
dsb	dan sebagainya
dsna	disana
dst	dan seterusnya
dstu	disitu
dtg	datang
dugem	dunia gemerlap
duh	aduh
duit	uang
dungu	bodoh
duren	durian
dy	dia
dzolim	zalim
ed	edisi
edan	gila
ego	emosi
egp	emang gue pikirin
eike	aku
eke	aku
elo	kamu
elu	kamu
elu	kamu
emang	memang
emangnya	memangnya
emank	memang
emg	memang
emng	memang
emte	makan teman
ena	enak
endak	tidak
engga	tidak
enggak	tidak
entar	nanti
entertainment	hiburan
envy	iri
epemilu	pemilu elektronik
epsd	episode
etc	et cetera
ex	mantan
ext	extension
fake	palsu
faktakta	fakta
fans	penggemar
faq	pertanyaan umum
fax	facsimile
fb	facebook
fham	paham
fhm	paham
fifo	first in first out
finek	finansial ekonomi
fitnag	fitnah
fix	pasti
folbek	ikuti balik
follback	ikuti balik
follow	ikuti
fresh	segar
ft	foto
fwd	diterukan
fyi	sebagai informasi
g	tidak
ga	tidak
gaada	tidak ada
gabisa	tidak bisa
gabut	gaji buta
gada	tidak ada
gaes	teman teman
gag	tidak
gahar	sangar
gaje	tidak jelas
gajebo	tidak jelas
gak papa	tidak apa apa
gak	tidak
gak	tidak
galau	bimbang
gamau	tidak mau
gan	juragan
gantengbs	ganteng
gantengsaya	ganteng
gapapa	tidak apa apa
gaptek	gagap teknologi
garing	hambar
gatau	tidak tahu
gatek	gagap teknologi
gatot	gagal total
gawe	kerja
gax	tidak
gblk	bodoh
gblok	bodoh
gbs	tidak bisa
gda	tidak ada uang
gebetan	orang yang disuka
geblek	bodoh
geer	gede rasa
gegara	gara gara
geje	tidak jelas
gelo	gila
gengges	ganggu
gepeng	gelandangan dan pengemis
gf	pacar
ggl	gagal
ghiey	lagi
ghiy	lagi
gi	lagi
gile	gila
gils	gila
giman	gigi mancung
gimana	bagaimana
gini	begini
gino	gigi nongol
gitchu	gitu
githu	gitu
gitu	begitu
gj	tidak jelas
gk	tidak
gmana	bagaimana
gmn	bagaimana
gmpng	gampang
gn	begini
goblog	bodoh
goblok	bodoh
gogon	go internasional
gokil	gila
goks	gila
golput	golongan putih
gombal	suka merayu
good	bagus
governor	gubernur
gowes	mengayuh sepeda
gpl	tidak pakai lama
gpny	tidak punya
gpp	tidak apa apa
gr	gede rasa
grammar	tata bahasa
gretong	gratis
gretongan	gratisan
gt	begitu
gt	gitu
gtau	tidak tahu
gtw	tidak tahu
gua	saya
gub	gubernur
gue	aku
guoblok		bodoh
guys	teman teman
gw	aku
gws	cepat sembuh
ha	tertawa
hacep	seru
haghaghag	tertawa
haha	tertawa
hahaha	tertawa
hhh	tertawa
hhhh	tertawa
hakhak	tertawa
hallo	halo
hallow	halo
hallow	halo
halow	halo
handak	bahan peledak
hankam		pertahanan dan keamanan
hansip	pertahanan sipil
happy	bahagia
hardcore	keras
hater	pembenci
haters	pembenci
hdp	hidup
hdr	hadir
hello	halo
hellow	halo
helo	halo
helow	halo
heter	pembenci
heters	pembenci
hey	hai
hi	hai
hit	terpopuler
hits	terkini
hlm	halaman
hlng	hilang
hny	hanya
hnya	hanya
hoax	isu bohong
hooree	hore
horee	hore
horeee	hore
horey	hore
horray	hore
houm	rumah
hr	hari
hrs	harus
hrus	harus
hubad	hubungan angkatan darat
hubdar	perhubungan darat
hubla	perhubungan laut
huff	mengeluh
huft	mengeluh
hum	rumah
humas	hubungan masyarakat
humoris	lucu
humz	rumah
hurray	hore
hurts	pedih
idk	saya tidak tahu
ig	instagram
ikon	lambang
ilang	hilang
ilfeel	tidak suka
ilfil	tidak suka
imba	jago sekali
imho	in my humble opinion
imoet	imut
imoetz	imut
indo	indonesia
info	informasi
insom	insomnia
iow	dengan kata lain
ipon	iphone
irit	hemat
isengin	bercanda
ista	nista
istaa	nista
item	hitam
itung	hitung
itungan	hitungan
iy	iya
iyala	iya lah
iye	iya
iyo	iya
ja	saja
jablay	jarang dibelai
jadiin	jadi
jadiin	jadikan
jadul	jaman dulu
jaim	jaga image
jancuk	anjing
janjinyaa	janji
jayus	tidak lucu
jd	jadi
jdi	jadi
jdi	jadi
jdikan	jadikan
jdnya	jadinya
jejeg	tegak
jem	jam
jentelmen	berani
jg	juga
jga	juga
jgan	jangan
jgn	jangan
jgnkan	jangankan
jijay	jijik
jir	anjing
jkt	jakarta
jl	jalan
jln	jalan
jls	jelas
jnj	janji
job	pekerjaan
jomblo	tidak punya pacar
jth	jatuh
jubir	juru bicara
jurdil	jujur adil
jutek	galak
jutek	galak
jwb	jawab
k	ke
ka	kakak
kab	kabupaten
kabag	kepala bagian
kabor	kabur
kacian	kasihan
kacrut	kacau
kadit	kepala direktorat
kadiv	kepala divisi
kaga	tidak
kagak	tidak
kaka	kakak
kalo	kalau
kampret	sialan
kamseupay	kampungan
kamtib	keamanan dan ketertiban
kamtibmas	keamanan dan ketertiban masyarakat
kamuh	kamu
kamuwh	kamu
kamyu	kamu
kanwil	kantor wilayah
kapt	kapten
karn	karena
karna	karena
kasat	kepala satuan
kasubbag	kepala subbagian
kasubbid	kepala subbidang
katrok	kampungan
kau	kamu
kayanya	kayaknya
kbar	kabar
kbr	kabar
kca	kaca
kcian	kasihan
kdu	harus
keburu	terlanjur
kec	kecamatan
kedubes	kedutaan besar
kei	kasih
kejurnas	kejuaraan nasional
kek	seperti
kekeuh	keras kepala
keknya	kayaknya
kel	kelurahan
keles	kali
keleus	kali
keliatan	kelihatan
kemaren	kemarin
keneh	masih
kengototan	keras kepala
kentot	senggama
kep	kepulauan
kepengen	mau
kepikiran	terpikirkan
kepingin	mau
kepo	penasaran
kepsek	kepala sekolah
kere	tidak punya uang
kesbang	kesatuan bangsa
kesian	kasihan
kesra	kesejahteraan rakyat
kesupen	lupa
ketauan	ketahuan
ketrima	diterima
ketum	ketua umum
keukeuh	keras kepala
kgiatan	kegiatan
kgk	kagak
khan	kan
kibul	bohong
kibus	kaki busuk
kicep	diam
kimpoi	kawin
kipak	bohong
kk	kakak
kk	kakak
kl	kalau
kl	kalau
klian	kalian
klianz	kalian
klo	kalau
klo	kalau
klon	duplikat
kloter	kelompok terbang
klrg	keluarga
klu	kalau
kluarga	keluarga
kluster	klaster
klw	kalau
klwrga	keluarga
km	kamu
km	kamu
kmari	kemari
kmn	kemana
kmps	kampus
kmpus	kampus
kmrmn	kameramen
kmrn	kemarin
kn	kan
knal	kenal
knl	kenal
knp	kenapa
knpa	kenapa
koar	teriak
kodya	kota madya
kog	kok
komdis	komisi disiplin
komnas	komisi nasional
kompi	komputer
komsov	komunis sovyet
komtiong	komunis Tiongkok
komun	komunitas
kongkow	kumpul bareng teman
konjen	konsulat jenderal
koosong	kosong
kopdar	kopi darat
koq	kok
korup	korupsi
kosoong	kosong
kovid	covid
kowe	kamu
kpd	kepada
kpn	kapan
kptsan	keputusan
kpu	komisi pemilihan umum
krenz	keren
krik	garing
krim	kirim
krm	kirim
krn	karena
krn	karena
krna	karena
ksng	kosong
ksong	kosong
kt	kita
ktauan	ketahuan
ktipu	tipu
ktmu	ketemu
ktny	katanya
ktr	kantor
kudu	harus
kumkeb		kumpul kebo
kumsalam	wallaikumsalam	
kuper	kurang pergaulan
kuq	kok
kurng	kurang
kw	imitasi
ky	seperti
kyk	seperti
kykny	sepertinya
kyknya	sepertinya
kzl	kesal
la	lah
laka	kecelakaan
lam	salam
lambreta	lambat
lamp	lampiran
lansia	lanjut usia
lanud	landasan udara
lapas	lembaga pemasyarakatan
latgab	latihan gabungan
lav	cinta
lavv	cinta
lbur	libur
lebeh	berlebihan
leh	boleh
lekong	laki
lelet	lambat
lemot	lambat
less	kurang
lg	lagi
lgi	lagi
lgkp	lengkap
lgs	langsung
lgsg	langsung
lht	lihat
liat	lihat
light	terang
link	tautan
link	tautan
linmas	perlindungan masyarakat
litbang	penelitian dan pengembangan
live	langsung
lmyan	lumayan
lmyn	lumayan
lngkp	lengkap
lnjut	lanjut
lo	kamu
loch	loh
loe	kamu
lol	tertawa
lola	lambat berfikir
lom	belum
lope	cinta
loph	cinta
louph	cinta
loupz	cinta
love	cinta
low	kalau
lowh	kamu
lp	lupa
lsg	langsung
lu	kamu
luber	langsung, umum, bebas, dan rahasia
luchu	lucu
luchuw	lucu
luff	cinta
lum	belum
luph	cinta
lur	saudara
lutchu	lucu
luthu	lucu
luthu	lucu
lw	kamu
lwn	lawan
lwt	lewat
lwt	lewat
maaci	terima kasih
maacih	terima kasih
maaciw	terima kasih
mabal	bolos
mabes	markas besar
mabok	mabuk
macem macem	macam macam
macem	macam
macih	masih
madesu	masa depan suram
maem	makan
maen	main
magabut	makan gaji buta
mager	malas gerak
mahatma	maju sehat bersama
maho	homoseksual
mainstream	sangat umum
mak jang	kaget
mak jegagik	kaget
mak tratap	kaget
mak	ibu
makasih	terima kasih
maksain	memaksa
malah	bahkan
malem	malam
males	malas
malu2in	memalukan
mam	makan
mamz	makan
maneh	kamu
manen	panen
manggil	panggil
manies	manis
maniez	manis
maniezt		manis
manist	manis
mantabss	bagus	
mantaph	bagus
mantapp	bagus
mantappp	bagus
mantep	mantap
mao	mau
markus	makelar kasus
masukin	masukkan
masy	masyarakat
matur	mengucapkan
maybe	mungkin
mb	mbak
mba	mbak
mbabibuta	ceroboh
mbaur	baur
mbual	bual
mbual	membual
mcm	macam
mehong	mahal
melu	ikut
menangi	menangkan
mending	lebih baik
meneketehe	tidak tahu
menel	centil
menolak	tolak
mepet	dekat sekali
mgkin	mungkin
mgkn	mungkin
mgkn	mungkin
mgu	minggu
mhn	mohon
migas	minyak dan gas bumi
miker	minuman keras
mikol	minuman beralkohol
milis	mailing list
mimin	admin
min	admin
minn	admin
miras	minuman keras
mkn	makan
mksd	maksud
mlah	malah
mlm	malam
mls	malas
mmg	memang
mndukung	mendukung
mngkn	mungkin
mniezt	manis
mnipu	tipu
mnis	manis
mnolak	tolak
mnt	minta
mo	mau
modar	mati
modus	maksud lain
moge	motor gede
mokad	mati
mokat	mati
money	uang
monitoring	pemantauan
moso	masa
mosok	masa
most	paling
mpe	sampai
mrk	mereka
mrka	mereka
msh	masih
msk	masuk
mskpn	meskipun
mslh	masalah
msng2	masing masing
mt	makan teman
muahal	mahal
muantap	bagus
muanteb	bagus
muantheb	bagus
mubes	musyawarah besar
much	lebih
muker	musyawarah kerja
mulu	melulu
mumet	pusing
mumpung	selagi
muna	munafik
munas	musyawarah nasional
munaslub	musyawarah nasional luar biasa
munfik	munafik
muntaber	muntah dan berak
mure	murah
musda	musyawarah daerah
musti	mesti
mutusin	memutuskan
muup	maaf
muuph	maaf
muupz	maaf
muuv	maaf
mw	mau
mz	mas
n	dan
naas	nahas
naiis	bagus
nais	bagus
naisu	bagus
naisuu	bagus
nal	kenal
nanam	menanam
nangis	menangis
nanya	bertanya
naon	apa
napa	kenapa
napi	narapidana
napol	narapidana politik
napza	narkotika, alkohol, psikotropika, dan zat adiktif 
naq	anak
narkoba	narkotika, psikotropika, dan obat terlarang
narsis	bangga pada diri sendiri
nasgor	nasi goreng
nax	anak
nda	tidak
ndak	tidak
ndiri	sendiri
ndut	gendut
ne	ini
nekolim		neokolonialisme
nekolin	neokolonialisme
nelfon	menelepon
nembak	menyatakan cinta
new	baru
news	berita
next	lanjut
ngabis2in	menghabiskan
ngabuburit	menunggu berbuka puasa
ngakak	tertawa
ngaku	mengaku
ngambek	marah
ngambil		mengambil
ngampus	pergi ke kampus
nganggur	tidak punya pekerjaan
ngantri	mengantri
ngapah	kenapa
ngapain		sedang apa
ngaret	terlambat
ngaruh	berpengaruh
ngasih	memberikan
ngawur	berbicara sembarangan
ngebandel	berbuat bandel
ngebully	intimidasi
ngeceng	kumpul bareng bareng
ngegosip	bergosip
ngeh	paham
ngeh	sadar
ngehe	kesal
ngeklaim	mengklaim
ngekos	tinggal di kos
ngeksis	menjadi eksis
ngelamar	melamar
ngeles	berkilah
ngeliat	melihat
ngelidur	menggigau
ngemeng	bicara terus	terusan
ngentot	senggama
ngentotin	senggama
ngerampok	merampok
ngeri	seram
ngerti	mengerti
ngeuh	paham
ngga	tidak
nggak	tidak
nggu	menunggu
ngibul	berbohong
ngikut	ikut
ngiler	mau
nginep	menginap
ngiri	iri
ngisi	mengisi
ngisiin	mengisikan
ngk	tidak
ngmg	bicara
ngmng	bicara
ngocol	lucu
ngomong	bicara
ngomongin	membicarakan
ngotot	keras kepala
ngubek2	mencari cari
ngumpet	sembunyi
ngumpul	berkumpul
ngurus	mengurus
ni	ini
nice	bagus
nie	ini
niech	nih
nih	ini
nimbrung	ikut serta
nipu	tipu
niyh	nih
nkah	nikah
nmenarik	menarik
nmr	nomor
nnti	nanti
nntn	nonton
no	nomor
nobar	nonton bareng
nongkrong	berkumpul
np	sedang memutar
nrp	narapidana
ntar	nanti
ntar	sebentar
ntn	nonton
ntn	nonton
nuhun	terima kasih
numpuk	bertumpuk
nunggu	menunggu
nutupin	menutupi
nw	sedang menonton
nyaingin	saing
nyalahin	salah
nyampah	membuat sampah
nyang	yang
nyari	mencari
nyariin	mencari
nyasar	tersesat
nyekar	menyekar
nyela	cela
nyembah	sembah
nyemot	ambil
nyerang	serang
nyiapin	mempersiapkan
nyicil	mencicil
nyiram	menyiram
nyoblos	mencoblos
nyok	ayo
nyokap	ibu
nyungsep	jatuh
o/	oleh
official	resmi
ogah	tidak mau
ok	ok
okt	oktober
ol	online
olh	oleh
omdo	hanya omong
ongkir	ongkos kirim
only	hanya
oon	bodoh
oot	out of topic
or	atau
ora tidak
orange	oranye
org	orang
org2	orang orang
orkes	olahraga dan kesehatan
ortu	orang tua
ospek	orientasi studi dan pengenalan kampus
otda	otonomi daerah
otre	oke
otw	sedang di jalan
our	kami
pa	apa
pacal	pacar
pahe	paket hemat
pake	pakai
pakek	pakai
pala	kepala
palbis	paling bisa
panja	panitia kerja
pansus	panitia khusus
pantura	pantai utara
paranoid	takut
parno	takut
parpol	partai politik
parte	partai
pas2an	pas pasan
paslon	pasangan calon
paslon	pasangan calon
pasutri	pasangan suami istri
patas	cepat dan terbatas
pcr	pacar
pcran	pacaran
pd	pada
pdhal	padahal
pdhl	padahal
pede	percaya diri
pelatda	pemusatan latihan daerah
pelatnas	pemusatan latihan nasional
pelototin	memelototi
pembokat	pembantu
pemda	pemerintah daerah
pemilu	pemilihan umum
pemkot	pemerintah kota
pemprov	pemerintah provinsi
pemred	pemimpin redaksi
penertiban	tertib
pengen	ingin
penjas	pendidikan jasmani
penmas	pendidikan masyarakat
perda	peraturan daerah
perek	wanita tuna susila
peres	palsu
perhatiin	perhatikan
personil	personel
pertamax	pertama
pesenan	pesanan
pesenin	pesankan
pg	pagi
pgang	pegang
pgg	pegang
pgi	pergi
photography	fotografi
php	pemberi harapan palsu
pi	tapi
pijetin	pijitkan
pilkada	pemilihan kepala daerah
pilwakot	pemilihan wali kota
pilwalkot	pemilihan wali kota
pimpro	pemimpin proyek
pisan	sangat
pisgor	pisang goreng
pk	pakai
pke	pakai
plg	paling
plg	pulang
plh	pilih
plis	tolong
pliss	tolong
pliz	tolong
pls	tolong
plz	tolong
pm	private message
pmrnth	pemerintah
pndukung	pendukung
pnh	pernah
pntg	penting
pny	punya
pny	punya
polantas	polisi lalu lintas
politic	politik
polres	kepolisian resor
polwan	polisi wanita
ponpes	pondok pesantren
ponsel	telepon seluler
pp	pulang pergi
ppa	apa
prasmu	perasaan saja
prcya	percaya
presh	segar
prg	pergi
prikitiw	cie
priksa	periksa
prnh	pernah
prnh	pernah
pro	profesional
problem	masalah
prototype	contoh
psen	pesan
psn	pesan
pst	pasti
pst	pesat
psti	pasti
pswt	pesawat
ptg	penting
ptgg	penting
puanas	panas
pulgar	kasar
puyeng	pusing
pw	posisi nyaman
qc	kontrol kualitas
qmo	kamu
qmu	kamu
qt	kita
quick	cepat
rakor	rapat koordinasi
rame	ramai
ranmor	kendaraan bermotor
raskin	rakyat miskin
re	balas
recokin	ganggu
red	redaksi
ref	referensi
reg	register
rehab	rehabilitasi
rejeki	rezeki
reklamuk	reklamasi
rempong	repot
rempong	sulit
renstra	rencana strategis
rep	balas
repp	balas
resiko	risiko
reskrim	reserse kriminal
restik	reserse narkotika
reti	mengerti
rhs	rahasia
ri	republik indonesia
rights	benar
rja	raja
rkyt	rakyat
rmbt	rambut
rmh	rumah
rofl	rolling on the floor laughing
rotfl	tertawa
ru	baru
rubahnn	rubah
rudal	peluru kendali
ruko	rumah toko
rusun	rumah susun
rusunawa	rumah susun sewa
rutan	rumah tahanan
ruz	terus
s4	sempat
sabeb	bebas
sabeb	bebas
sadaar	sadar
saia	saya
saiank	sayang
salting	salah tingkah
saltum	salah kostum
samlekom	assalamuallaikum
samlekum	assalamuallaikum
sampe	sampai
sampeyan	anda
samsek	sama sekali
sapa	siapa
sapose	siapa
satkorlak	satuan koordinator pelaksana
satpam	satuan pengamanan
say	sayang
sayan	sayang
sbb	sebagai berikut
sbg	sebagai
sbh	sebuah
sblm	sebelum
sbnrny	sebenarnya
scara	secara
schedule	jadwal
scr	secara
sdg	sedang
sdgkn	sedangkan
sdh	sudah
sdh	sudah
sdkt	sedikit
sdngkn	sedangkan
se7	setuju
seabrek	banyak
sebelas dua belas	mirip
sebelom	sebelum
sekjen	sekretaris jenderal
selow	santai
semau	asal
sembako	sembilan bahan pokok
sempak	celana dalam
sempet	sempat
sempet2nya	sempat sempatnya
sendratari	seni drama tari
sengeni	dimarahi
sept	september
serasiii	serasi
sertijab	serah terima jabatan
seting	akting
setting	atur
setting	atur
sgt	sangat
sgt	sangat
sgtu	segitu
sgtuny	segitunya
sgtunya	segitunya
sh	masih
shg	sehingga
sidak	inspeksi mendadak
siech	sih
sieyh	sih
sikon	situasi dan kondisi
simiskin	miskin
simpedes	simpanan pedesaan
sinetron	sinema elektronik
sip	ok
siramin	siramkan
sis	kakak perempuan
sj	saja
sjjurny	sejujurnya
skali	sekali
skali	sekali
skalian	sekalian
skl	sekali
sklh	sekolah
skrg	sekarang
skrg	sekarang
skt	sakit
skul	sekolah
skuy	ayo
slalu	selalu
slama	selama
slesai	selesai
slh	salah
slh	salah
sll	selalu
sll	selalu
slm	salam
slma	selama
slmt	selamat
slsai	selesai
slt	sulit
slur	saudara
sm	sama
sma	sama
smg	semoga
smg	semoga
smga	semoga
smpt	sempat
smua	semua
smw	semua
smwny	semuanya
smwnya	semuanya
sndiri	sendiri
sng	senang
sni	sini
soft	halus
sohib	teman
soljum	sholat jumat
solve	solusi
somse	sombong sekali
songong	sombong
sorry	maaf
sory	maaf
sosbud	sosial budaya
sosek	sosial ekonomi
sospol	sosial politik
sotoy	sok tahu
sowry	maaf
spa	siapa
spd	sepeda
sppa	siapa
sprti	seperti
spt	seperti
spy	supaya
srtfkt	sertifikat
stage	panggung
stelah	setelah
stiap	setiap
stiap	setiap
still	masih
stj	setuju
stlh	setelah
stop	henti
stuju	setuju
subbag	subbagian
suk	masuk
sumbangin	sumbangkan
sumpek	sempit
suwun	terima kasih
sy	saya
sya	saya
syg	sayang
syg	sayang
syp	siapa
t4	tempat
tabanas		tabungan pembangunan nasional
tahi	kotoran
tai	kotoran
taik	kotoran
taik	tahi
tajir	kaya
tak	tidak
taping	perekaman
tar	nanti
tau	tahu
tauk	tahu
taun	tahun
taw	tahu
tawh	tahu
td	tadi
tdi	tadi
tdk	tidak
tdk	tidak
te2p	tetap
team	tim
tekor	rugi
telat	terlambat
telkom	telekomunikasi
telmi	telat berpikir
telp	telepon
temen	teman
temen2	teman teman
tengil	menyebalkan
tengok	menjenguk
tengsin	malu
tepar	terkapar
terbitin	terbitkan
teteh	kakak perempuan
tggu	tunggu
tgl	tanggal
tgu	tunggu
thanks	terima kasih
thankz	terima kasih
thd	terhadap
thn	tahun
thn	tahun
thx	terima kasih
tik	cantik
tilang	bukti pelanggaran
tilep	tilap
timses	tim sukses
tipi	TV
tipiwan	TvOne
tirani	tiran
tkg	tukang
tks	terima kasih
tkt	takut
tll	terlalu
tlp	telepon
tlpn	telepon
tls	tulis
tman	teman
tmbah	tambah
tmbh	tambah
tmen2	teman teman
tmn2	teman teman
tmpah	tumpah
tmph	tumpah
tmpt	tempat
tnda	tanda
tngu	tunggu
tnh	tanah
tnyta	ternyata
togel	toto gelap
toserba	toko serba ada
toys	main
tp	tapi
tpi	tapi
tpii	tapi
tps	tempat pemungutan suara
tq	terima kasih
trdhulu	terdahulu
tren	tren
trending	tren
trgntg	tergantung
trima	terima kasih
trims	terima kasih
trimz	terima kasih
trlalu	terlalu
trm	terima
trnyt	ternyata
trs	terus
trus	terus
trus	terus
trutama	terutama
trz	terus
ts	penulis
tsangka	tersangka
tsb	tersebut
tsk	tersangka
tst	tahu sama tahu
ttd	tertanda
ttg	tentang
ttp	tetap
tuch	tuh
tuh	itu
tuir	tua
tuwh	tuh
tw	tahu
tw	tau
tyap	tiap
typo	salah tulis
u	kamu
u	you
u/	untuk
uasai	kuasa
ucul	lucu
ud	sudah
uda	sudah
udah	sudah
udh	sudah
ujg	ujung
ujung2nya	ujung ujungnya
ujungÂ²nya	ujung ujungnya
ul	ulangan
ultah	ulang tahun
unyu	menggemaskan
update	pembaruan
upload	unggah
uplot	unggah
uppu	apa
urang	saya
urg	saya
usah	perlu
utang	hutang
utip	kutip
utk	untuk
utul	ujian tertulis
valas	valuta asing
valid	sah
variant	varian
variants		varian
via	melalui
victory	menang
vidio	video
viruss	virus
virusss	virus
vn	catatan suara
vocher	voucher
vol	volume
vote	pilih
vrus	virus
w/	dengan
wad	buat
wadir	wakil direktur
waduh	aduh
wagub	wakil gubernur
waka	wakil kepala
wamil	wajib militer
war	perang
waria	wanita pria
warkop	warung kopi
warnet	warung internet
warteg	warung tegal
wartel	warung telekomunikasi
waspadalah	waspada
wat	buat
watuk	batuk
wayahe	saatnya
webinar	seminar berbasis internet
wes	sudah
wib	waktu indonesia barat
wis	sudah
wis	sudah
wit	waktu indonesia timur
wita	waktu indonesia tengah
with	dengan
wk	tertawa
wkt	waktu
wkwk	tertawa
wkwkkw	tertawa
woles	santai
wtf	apa apaan
wtf	what the fuck
wth	what the hell
wuih	wah
wuihh	wah
wuuih	wah
x	kali
xixixi	tertawa
y	kenapa
y	ya
y	ya
ya	iya
yad	yang akan datang
yap	iya
yapz	iya
yaudah	ya sudah
yauwda	ya sudah
yawda	ya sudah
yawdah	ya sudah
ybs	yang bersangkutan
yg	yang
yg	yang
yi	yaitu
yl	yang lain
yng	yang
yo	iya
yo	iya
yoha	iya
yok	ayo
yowes	ya sudah
yuk	ayo
yup	iya
ywdh	ya sudah
zonk	mengecewakan
